{
  "levels": [
    {
      "words": ["BIRD", "BUG", "CLOUD", "APPLE"],
      "grid": [
        ["C", "P", "K", "I", "T", "E"],
        ["L", "B", "T", "I", "M", "E"],
        ["O", "D", "I", "B", "C", "M"],
        ["U", "T", "X", "R", "U", "S"],
        ["D", "N", "C", "E", "D", "G"],
        ["N", "A", "P", "P", "L", "E"]
      ]
    },
    {
      "words": ["LOVE", "HOPE", "WORD", "LOW"],
      "grid": [
        ["L", "O", "V", "E", "X", "Y"],
        ["X", "H", "O", "P", "E", "Y"],
        ["X", "X", "W", "O", "R", "D"],
        ["X", "X", "X", "L", "O", "W"],
        ["X", "X", "X", "X", "X", "X"],
        ["X", "X", "X", "X", "X", "X"]
      ]
    },
    {
      "words": ["LOVE", "HOPE", "WORD", "LOW"],
      "grid": [
        ["L", "O", "V", "E", "X", "Y"],
        ["X", "H", "O", "P", "E", "Y"],
        ["X", "X", "W", "O", "R", "D"],
        ["X", "X", "X", "L", "O", "W"],
        ["X", "X", "X", "X", "X", "X"],
        ["X", "X", "X", "X", "X", "X"]
      ]
    }
  ]
}
